NO                   ./textures/north.png                   
F 220,100,1
SO ./textures/south.png
C 225,30,99
WE ./textures/west.png
EA ./textures/east.png




111111111111111111111111111111
100000000000100000000000000001
101111111110000000000011111101
101000010000001111000000000101
101000000N00010000000000000101
101000000000011111111100000101
101111111110000000000011111101
100000000000000000000000000001
100000000000011111000000000001
100000000000011111111100000101
100000000000000000000011111101
100000000000000000000000000001
111111111111111111111111111111


