NO                   ./textures/north.png                   
F 220,100,1
SO ./textures/south.png
C 225,30,99
WE ./textures/west.png
EA ./textures/east.png




11111111111111111111111111111111111111
10000000000111000000000000011111110111
10000000000111000000000000011111110111
10000000000111000000000000011111110111
10000000000111000000000000000000000111
10000000000000000000N00000000111110101
10000000000111000000000000011111110111
10000000000111000000000000011111110111
10000000000111000000000000011111110111
10000000000111000000000000011111110111
10000000000111000000000000011111110111
10000000000111000000000000011111110111
10000000000111000000000000011111110111
10000000000111000000000000011111110111
10000000000111000000000000011111110111
10000000000111000000000000011111110111
11111111111111111111111111111111111111


