NO ./textures/north.png    
SO ./textures/south.png
WE ./textures/west.png
EA ./textures/east.png

F 20,20,+20
C -200, 200,200

      1
   1 111111
11101111N11111111111
100000000001
100000000001
111111111111